Pop2000                                              
We belong together - Mariah Carey
Yeah!  - Usher ,Lil jon ,and Ludacris
I gotta feeling - black eyes peas
Gold Digger - Kanye west and Jamie foxx
Bleeding love - Leona Lewis
Hey ya - OutKast
What a girl wants - Christina Aguilera
Sine u been gone - Kelly Clarkson
Single Ladies - Beyonce
Frontin - Pharrell
Family affair - Mary J. Blige

Pop2008
Bleeding Love - Leona Lewis                                                                                                            
I Kissed A Girl - Katy Perry                                                                                                           
Low - Flo-Rida & T-Pain                                                                                                                
So What - Pink                                                                                                                         
Just Dance - Lady GaGa & Colby O'Donis                                                                                                 
Four Minutes - Madonna & Justin Timberlake                                                                                             
Hot 'n' cold - Katy Perr                                                                                                               
All summer long - Kid Rock                                                                                                             
Viva La Vida - Coldplay                                                                                                                
I am Yours - Jason Mraz                                                                                                                
Take a Bow - Rihanna                                                                                                                   
Disturbia - Rihanna                                                                                                                    
Mercy - Duffy                                                                                                                          
No Air - Jordin Sparks & Chris Brown                                                                                                   
If I Were a Boy - Beyonce                                                                                                              
Womanizer - Britney Spears                                                                                                             
Love Song - Sara Bareilles                                                                                                             
Love In This Club - Usher & Young Jeezy                                                                                                
Forever - Chris Brown                                                                                                                  
American Boy - Estelle & Kanye West

Pop2015
Uptown Funk - Mark Ronson featuring Bruno Mars                                                                                       
Thinking Out Loud - Ed Sheeran                                                                                                      
See You Again - Wiz Khalifa featuring Charlie Puth                                                                                    
Trap Queen - Fetty Wap                                                                                                               
Sugar - Maroon                                                                                                                  
Shut Up and Dance - Walk the Moon                                                                                              
Blank Space - Taylor Swift                                                                                                            
Watch Me - Silentó                                                                                                                   
Earned It - The Weeknd                                                                                                               
The Hills - The Weeknd                                                                                                                
Cheerleader - OMI                                                                                                                   
Can't Feel My Face - The Weeknd                                                                                                     
Love Me Like You Do - Ellie Goulding                                                                                                 
Take Me to Church - Hozier                                                                                                          
Bad Blood - Taylor Swift featuring Kendrick Lamar                                                                                    
Lean On - Major Lazer and DJ Snake featuring MØ                                                                                      
Want to Want Me - Jason Derulo                                                                                                       
Shake It Off - Taylor Swift                                                                                                          
Where Are Ü Now - Skrillex and Diplo featuring Justin Bieber                                                                         
Fight Song - Rachel Platten 