Rap2000
Hot Boyz - Missy Elliott featuring Nas, Eve and Q-Tip
Whistle While You Twurk - Ying Yang Twins
Flamboyant - Big L
Callin' Me - Lil Zane featuring 112
Bounce with Me - Lil' Bow Wow featuring Xscape
Get Low - Lil Jon & The East Side Boyz
Move Somethin'- Talib Kweli and Hi-Tek (Reflection Eternal)
It's OK - Slimm Calhoun featuring André 3000
Souljas - Master P
Baby if You're Ready - Doggy's Angels featuring LaToiya
Oh No - Mos Def and Pharoahe Monch featuring Nate Dogg
Drop It Like It's Hot - Snoop Dogg
Ms. Jackson - Outkast
It Wasn't Me - Shaggy featuring Ricardo "Rikrok" Ducent	
Bow Wow (That's My Name) - Lil' Bow Wow	
What Would You Do? - City High	
Lose Yourself - Eminem	

Rap2008
Got Money – Lil Wayne ft. T-Pain
Foolish – Shawty Lo
Can’T Believe It – T-Pain Featuring Lil Wayne
I’ve Changed – Jaheim ft. Keyshia Cole
Miss Independent – Ne-Yo
With You – Chris Brown
Mrs. Officer – Lil Wayne Featuring Bobby Valentino & Kidd Kidd
Bye Bye – Mariah Carey
Until The End Of Time – Justin Timberlake Duet With Beyonce
Game’s Pain – The Game ft. Keyshia Cole
Good Life – Kanye West Featuring T-Pain
Stay Down – Mary J. Blige
Magic – Robin Thicke
Low – Flo Rida Featuring T-Pain
Shoulda Let You Go – Keyshia Cole Introducing Amina
Suga Suga Suga – 4Keith Sweat ft. Paisley Bettis
Kiss Kiss – Chris Brown Featuring T-Pain
That’s Gangsta – Bun B ft. Sean Kingston
I Know – Jay-Z ft. Pharrell
Flashing Lights – Kanye West Featuring Dwele
I Won’T Tell – Fat Joe Featuring J. Holiday

Rap2015
See You Again - Wiz Khalifa Featuring Charlie Puth 
Trap Queen - Fetty Wap
Watch Me - Silento
679 - Fetty Wap Featuring Remy Boyz
Hotline Bling - Drake  
Time Of Our Lives - Pitbull & Ne-Yo  
G.D.F.R. - Flo Rida Featuring Sage The Gemini & Lookas
My Way - Fetty Wap Featuring Monty
Nasty Freestyle - T-Wayne
Only - Nicki Minaj Featuring Drake, Lil Wayne & Chris Brown
I Don't F**k With You - Big Sean Featuring E-40
Flex (Ooh Ooh Ooh) - Rich Homie Quan
Truffle Butter - Nicki Minaj Featuring Drake & Lil Wayne
All Eyes On You - Meek Mill Featuring Chris Brown & Nicki Minaj
Blessings - Big Sean Featuring Drake
No Type - Rae Sremmurd
CoCo - O.T. Genasis
Hit The Quan - iLoveMemphis
Downtown - Macklemore & Ryan Lewis Featuring Eric Nally, Melle Mel, Kool Moe Dee & Grandmaster Caz
Energy - Drake