R&B2000
Let's Get Married - Jagged Edge  
I Wanna Know - Joe
Incomplete - Sisqo
Get It On Tonite - Montell Jordan
No More - Ruff Endz
I Wish - Carl Thomas
Separated - Avant
Say My Name - Destiny's Child
Bag Lady - Erykah Badu
Thong Song - Wifey
He Wasn't Man Enough - Toni Braxton
He Can't Love U - Jagged Edge
Try Again - Aaliyah
(Hot S**t) Country Grammar - Nelly
Shake Ya Ass - Mystikal

R&B2008
Just Dance - Lady Gaga
Single Ladies (Put a Ring on It) - Beyoncé  
Like You'll Never See Me Again - Alicia Keys
I Remember - Keyshia Cole 
Lollipop - Lil Wayne Featuring Static Major  
Love In This Club - Usher Featuring Young Jeezy 
Take a Bow - Rihanna 
Whatever You Like - T.I.  
Live Your Life - T.I. (Featuring Rihanna) 
Miss Independent - Ne-Yo 
Touch My Body - Mariah Carey 
Heartless - Kanye West 
Suffocate - J. Holiday  
Dead and Gone - T.I. 
A Milli - Lil Wayne 
Spotlight - Jennifer Hudson  
Can't Believe It - T-Pain Featuring Lil Wayne  
No Air - Jordin Sparks 
Day 'N' Nite - Kid Cudi 
Just Fine  - Mary J. Blige 

R&B2015
Blase - Ty Dolla $ign Featuring Future & Rae Sremmurd                                                                               
LSD - ASAP Rocky                                                                                                                   
Charged Up - Drake                                                                                                             
Digital Dash - Drake & Future                                                                                                 
Ride Out - Kid Ink, Tyga, Wale, YG, Rich Homie Quan                                                                         
Trouble - Iggy Azalea Featuring Jennifer Hudson                                                           
Soldier - Damien                                                                                                                    
Bad For You - Meek Mill Featuring Nicki Minaj                                                                                      
Real Life - The Weeknd                                                                                                            
Kings Never Die - Eminem Featuring Gwen Stefani                                                                                    
Alright - Kendrick Lamar                                                                                                             
Yoga - Janelle Monáe & Jidenna                                                                                                   
Scholarships - Drake & Future                                                                                                        
The Blacker The Berry - Kendrick Lamar                                                                                              
Preach - Drake Featuring PARTYNEXT DOOR                                                                                             
F**k Tha Police - N.W.Aavi$ Scott Featuring Future & 2 Chainz
3500 - Travi$ Scott Featuring Future & 2 Chainz                
Not For Long - B.o.B Featuring Trey Songz                                                                                            
The Body - Wale Featuring Jeremih                                                                                                     
Coffee - Miguel5                                                                                                                       
No Tellin' - Drake      